###############
#o  #   #   # #
###   #   # # #
#   # ##### # #
# ###   #     #
# #   # # ## ##
# # ### #  #  #
# #   # ## ## #
# ### #    #  #
#   ######## ##
###   #       #
# # # # ##### #
# # ### #   ###
#   #     #  x#
###############