###############
#o  ###########
### ###########
### ###########
### ###########
### ###########
### ###########
###   ###   ###
########### ###
########### ###
########### ###
########### ###
########### ###
###########  x#
###############

###############
###############
###############
###############
###############
###############
###############
#####     #####
###############
###############
###############
###############
###############
###############
###############