###############
###############
###############
###############
###############
###############
###############
#o  ##   ##   #
###############
###############
#   ##   ##   #
###############
###############
#   ##   ##  x#
###############

###############
###############
###############
###############
###############
###         ###
### ####### ###
### ## # ## ###
###### #    ###
###### ########
###    # ## ###
### #### ## ###
### #### ## ###
### ## #    ###
###############