###############
# # ##    ### #
# #    ###### #
# ## # #      #
#    ######## #
# ## ####   ###
#  # ##########
## #  o#x  ####
#  ####### #  #
# ##     # # ##
# ######## # ##
# ###   ## #  #
# ########### #
#   #   ###   #
###############

###############
#   #####     #
###############
######## ## ###
######## ## ###
####     ## ###
###########   #
##   ######## #
############# #
##### ##   ####
##### #########
#   # # #  ####
### ##### #####
###   # #   ###
###############