###############
####### #######
####### #######
####### #######
####### #######
####### #######
####### #######
#      o      #
####### #######
####### #######
####### #######
####### #######
####### #######
####### #######
###############

###############
#####     #####
###############
###############
###############
# ########### #
# ########### #
# ########### #
# ########### #
# ########### #
###############
###############
###############
#####     #####
###############

###############
##### ### #####
##### ### #####
##### ### #####
###############
#   #######   #
###############
###############
###############
#   #######   #
###############
##### ### #####
##### ### #####
##### ### #####
###############

###############
###############
###############
####   #   ####
### ####### ###
### ####### ###
### ####### ###
###############
### ####### ###
### ####### ###
### ####### ###
####   #   ####
###############
###############
###############

###############
###### # ######
###### # ######
###### # ######
###### # ######
###### # ######
#     ###     #
###############
#     ###     #
###### # ######
###### # ######
###### # ######
###### # ######
###### # ######
###############

###############
###    #    ###
###############
# ########### #
# ########### #
# ####   #### #
# ### ### ### #
##### ### #####
# ### ### ### #
# ####   #### #
# ########### #
# ########### #
###############
###    #    ###
###############

###############
###############
###############
#    #####    #
###############
###############
###############
###############
###############
###############
###############
#    #####    #
###############
###############
###############

###############
###############
###############
#### ##### ####
#### ##### ####
#### ##### ####
###############
###############
###############
#### ##### ####
#### ##### ####
#### ##### ####
###############
###############
###############

###############
###############
###############
###############
###############
####   x## ####
###############
###############
###############
#### ##### ####
###############
###############
###############
###############
###############