###############
#             #
# ##### ##### #
# ##### ##### #
# ##### ##### #
# ##### ##### #
# ##### ##### #
#      o      #
# ##### ##### #
# ##### ##### #
# ##### ##### #
# ##### ##### #
# ##### ##### #
#             #
###############

###############
# ########### #
###############
###############
###############
###############
###############
###############
###############
###############
###############
###############
###############
# ########### #
###############

###############
# ########### #
###############
#######   #####
######### #####
###     # #####
### ###   #####
### ### # # ###
###   # # # ###
#####   #   ###
###### #### ###
######     x###
###############
# ########### #
###############

###############
# ########### #
###############
####### #######
####### #######
####### #######
###############
###   # #   ###
###############
####### #######
####### #######
####### #######
###############
# ########### #
###############

###############
# ########### #
###############
###############
###############
####### #######
###############
##### # # #####
###############
####### #######
###############
###############
###############
# ########### #
###############

###############
# ########### #
###############
###############
###############
###############
###############
##### # # #####
###############
####### #######
###############
###############
###############
# ########### #
###############

###############
# ########### #
###############
###############
###############
####### #######
###############
##### ### #####
###############
####### #######
###############
###############
###############
# ########### #
###############

###############
# ########### #
###############
###############
###############
####### #######
###############
##### # # #####
###############
###############
###############
###############
###############
# ########### #
###############

###############
# ########### #
###############
###############
###############
####### #######
###############
##### # #######
###############
####### #######
###############
###############
###############
# ########### #
###############

###############
# ########### #
###############
###############
###############
####### #######
###############
##### # # #####
###############
####### #######
###############
###############
###############
# ########### #
###############

###############
# ##### ##### #
####### #######
####### #######
####### #######
####### #######
###############
#     # #     #
###############
####### #######
####### #######
####### #######
####### #######
# ##### ##### #
###############

###############
# ##### ##### #
###############
###############
###############
###############
###############
# ##### ##### #
###############
###############
###############
###############
###############
# ##### ##### #
###############

###############
#             #
# ##### ##### #
# ##### ##### #
# ##### ##### #
# ##### ##### #
# ##### ##### #
#             #
# ##### ##### #
# ##### ##### #
# ##### ##### #
# ##### ##### #
# ##### ##### #
#             #
###############